1111111111111
10000T0000FFF
1010001001111
1010100001
1011110001
1000000001
1DM00011M1
100M000001
1000000001
1111111111